
Steely dan: Aja, The Royal Scam
Leprous: Aphelion, Bilateral
Ulver: Shadows of the sun, The assassination of Julius Caesar
Sleep Token: This place will become your tomb, Take me back to eden
Porcupine Tree: Fear of a blank planet, In Absentia, Deadwing, Lightbulb sun
Tool: Ænima, Lateralus, 10000 days
Opeth: Still life, Blackwater park, Ghost reveries, Deliverance & Damnation (remixed)
Katatonia: The great cold distance
TesseracT: Sonder
Earthside: A dream in static
In flames: Clayman
Gorillaz: Demon days
Kyuss: Welcome to sky valley
Supertramp: Crime of the century, Breakfast in america
Queens of the stone age: Songs for the Deaf
Twelve foot ninja: Silent machine
Soilwork: The living infinite, Figure number five
Plini: Handmade cities
SikTh: The future in whose eyes
The pineapple thief: Dissolution
Steven Wilson: Hand cannot erase, The raven that refused to sing,
Casualties of cool: Casualties of cool
Gojira: From Mars to Sirius, L'enfant sauvage
Haken: The mountain
The Ocean: Phanerozoic 1: Palaeozoic, Pelagial
Soen: Lotus
Mathias Eick: Ravensburg
Vola: Witness, Applause of a distant crowd
Men I trust: Oncle Jazz
Karnivool: Sound awake
Vulkan: Technatura
MEER: Playing house
Hiromi: Alive
Tigram Hamasyan: Atmosphères, Mockroot
Esbjörn Svensson Trio: Seven days of falling
Alcest: Spiritual Instinct
Alfa Mist: Antiphon
Matthew Halsall: Colour Yes
Alice in Chains: Dirt
Morphine: Cure for pain
Pat Metheny, Lyle Mays: As falls Wichita - so falls wichita falls
Eberhard Weber: The colours of Chloë
Chick Corea: Return to forever
Trees of eternity: Hour of the Nightingale
Ihsahn: Pharos, Arktis.
Mr. Bungle: California
Blood command: Funeral Beach
Ne Obliviscaris: Portal of I
Elder: Dead Roots Stirring
Cynic: Kindly bent to free us

